###############
#S#           #
# # # ####### #
# # #     #   #
# ####### # ###
# #     # #   #
# # ### # ### #
# #   #   #   #
# # # ##### ###
# # # #   #   #
# ### # # ### #
# #   # # #   #
# # ### # # ###
#   #   #    E#
###############
