###############
#S    #     # #
##### # # # # #
# #   # # #   #
# # ### # ### #
# #   # # # # #
# ### ### # # #
#   # #   # # #
# # # # ### # #
# # # # #   # #
# ### # ### # #
# #   # #   # #
# # ### # ### #
#       #    E#
###############
